18
##################
##################
##....######....##
#.....######....##
#......####.....##
#......####.....##
#.......##......##
#.......##......##
#...............##
#...............##
#...............##
#....#......#...##
#....#.....##...##
#....##....##...##
#....##....##...##
#SSSS########FFF##
##################
##################