10
SSSSSSSSSS
SSSSSSSSSS
SSSSSSSSSS
..........
..........
..........
..........
FFFFFFFFFF
FFFFFFFFFF
FFFFFFFFFF